###########
#P $$$$$ P#
# #$#$#$# #
#$$$$$$$$$#
#$#$#$#$#$#
#$$$$$$$$$#
#$#$#$#$#$#
#$$$$$$$$$#
# #$#$#$# #
#P $$$$$ P#
###########